1
5 34
##################################
#.....X..$........E...........#.>#
#.@...........................##.#
#........E.................##....#
##################################

